A      #     #     #   #
    #  #  #  # #   #   # #  #
   #    #  #     #     # #     
  #  #     # #   #        #
 #   #  #  # # # #  #  #    #  #
 #   # #  # #  # # #  # #  #  # #
 #  #  #      #   #    #B #
